SO ./img/so.xpm         
NO ./img/no.xpm         
WE ./img/we.xpm         
EA ./img/ea.xpm                 
    
C 204,255,255         
F 255,102,102            
 
    
    
      1111111111111111111111111111111111111111         
 111111010000000000000000000000011    11111            
 10000000000000000000000000000000111   111111111111    
 11000000000000000011110000000000001   110000000001    
 1111111111111111111  11111110111111   111111111001    
                           10001               1001    
 11111111111111111     111110001111111111111   100111  
 11000000000000011    1100000000000000000001   100001  
 10000000000000001    1000000000000000000001   11000111
 11000000000000011    1100000000000111110001   100000001 
 1000000000000001      1000000000001   10001   10000011
 11100000000000011111111000000000001   10001   100000111
  111100000000000000100000000000001   10001  1100000001
  1111000000000000001000000000000001   10001  1000000001
  110000000000000000000N0000001111111   11111  1000111111
  11111000001100000000000000000001            10001    
111000000000000000000000000001111111111111111110001    
111111000000000000000000000000000000000000000000001    
    11111100000000000000000011111111111111111000001    
        111111000000000111111            111111111   11111111111111111111111111111111111111111111111
            11111111211111111111                       1000000000000000000000000000000000000000000011
                  110011                        11111110000000000111111111111110001111111111111111111
11111111111111111111001111111111111111111111111110000000000000000100000000000000000000000000000001
11111111111111111111001111111111111111111111111110000000000000000100000000000000000000000000000001
11111111111111111111001111111111111111111111111110000000000000000100000000000000000000000000000001
11111111111111111111001111111111111111111111111110000001111111111111111111111111111111111111111111
                  110011                     111100000011
                  110011                     100000000011
                  110011                     100111100011
                  110011                     1001  100011
                  1111111                    1111111111111
