SO ./img/so.xpm         
NO ./img/no.xpm         
WE ./img/we.xpm         
EA ./img/ea.xpm                 

C                   204,255,255                                             
F                   255,102,102                                                     

                                                    
                                                       
1111111111111111111111111111111111111111         
111111111103N111111111111111
1111111111111111111111111111111111111111    